########___#0
#      # . #1
# 1304 |.. #2
#      # . #3
######## . #4
#      # . #5
# 1303 |.. #6
#      # . #7
######## . #8
#      # . #9
# 1302 |.. #A
#      # . #B
######## . #C
#      # . #D
# 1301 |P. #E
#      # . #F
############G
0123456789AB