########___#
#      # . #
# 1304 |.. #
#      # . #
######## . #
#      # . #
# 1303 |.. #
#      # . #
######## . #
#      # . #
# 1302 |.. #
#      # . #
######## . #
#      # . #
# 1301 |P. #
#      # . #
############