##########
#*R...***#
#**.....*#
#R*...*R*#
#.....***#
#***.....#
#R.......#
#***....*#
#P.....**#
##########